NO texture/cobblestone.xpm
SO texture/color_stone.xpm
WE texture/wall1v.xpm
EA texture/mycelium_top.xpm

F 220,500,125
C 225,30,0,125

1111
10N1
1111
