NO texture/cobblestone.xpm
SO texture/color_stone.xpm

WE texture/wall1v.xpm
EA texture/mycelium_top.xpm

C 220,100,125



1111
10N1
1111
