
EA texture/cobblestone.xpm

EA

F 34,139,34
C 135,206,235

1111
10N1
1111
