NO texture/cobblestone.xpm
SO texture/color_stone.xpm

WE texture/wall1v.xpm
EA texture/mycelium_top.xpm
F 220,100,0
C 225,30,0

1111111111
1000100001
1100000111
1000000001
1000110001
1000000N01
1011000001
10000001N1
1000000111
1111111111
