1111111111111
10N0000000001
1000000000001
100000T000001
1111111111111
