NO texture/cobblestone.xpm
SO texture/color_stone.xpm

WE texture/wall1v.xpm
EA texture/mycelium_top.xpm

F 220,100,0
C 225,30,0


1111111N1111111


