NO texture/cobblestone.xpm
SO texture/color_stone.xpm

WE texture/wall1v.xpm
EA texture/mycelium_top.xpm
F34,139,34
C 135,206,235


1111111111111   111111111111
1000000000000001100000010001
1000000000000001101010000001
1000000000000000000000000001
10000000000000S0000000000001
1111111111111111111111111111


