NO walls/concrete.xpm
SO walls/NO.xpm
EA walls/so_beige.xpm
WE walls/EA.xpm
F34,139,34
C 135,206,235

1 11
10N1
1111


