
NO walls/NO.xpm
EA walls/EA.xpm
SO walls/concrete.xpm
WE walls/NO.xpm

F 34,139,34
C 135,206,235

111  1
10N001
111111
