NO walls/concrete.xpm
SO walls/NO.xpm
EA walls/so_beige.xpm
WE walls/EA.xpm
F34,139,34
   C 135,206,235

   1111111111111111111111111
   1111111111111111111111111
1111000000000001101010000001
1000000000000000000000000001
10000000000000S0000000000001
1000011000000000000000000001111
1000000000000000000000000111
10000000000000000000000001
1000000000000000000000000111
1000000000000000000000000001
1100001010101111101111000111
111101111110101 101111000001
111111111111111 111111111111


