NO texture/brick3.xpm
SO texture/brick4.xpm
WE texture/ceil4.xpm
EA texture/wall2h.xpm


F 184,113,39
C 51,198,227

111111
100001
100N01
111111
