NO texture/cobblestone.xpm
SO texture/color_stone.xpm
WE texture/wall1v.xpm
EA texture/mycelium_top.xpm
F 139,69,19
C 135,206,235

111111
100001
100N01
111111
