NO texture/anime_girl_wall.xpm
SO texture/warped_nylium.xpm

WE texture/arcade_cabinet.xpm
EA texture/princess_wall.xpm

F 139,69,190
C 135,206,235

        1111111111111111111111111
        1000000000110000000000001
        1011000001110000000000001
        1001000000000000000000001
111111111011000001110000000000001
100000000011000001110111111111111
111101111111110111000000D0001
11110111111111011101010010001
11000000110101D11100000010001
10000000000000000000000010001
10000000000000001101010010001
11000001110101D11111011110W0111
11110111 1110101 101111010001
11111111 1111111 111111111111
