NO texture/synthwave_grid.xpm
SO texture/arcade_cabinet.xpm
WE texture/ceiling.xpm
EA texture/wall4.xpm
F 230,100,200
C 250,60,0

        1111111111111111111111111
        1000000000110000000000001
        1011000001110000000000001
        1001000000000000000000001
111111111101100000110000000000001
100000000001000001110111111111111
11110111111111011100000000001
11110111111111011101010010001
11000000110101011100000010001
10000000000000001100000010001
10000000000000001101010010001
11000001110101011111011110N0111
11110111 1110101 101111010001
11111111 1111111 111111111111
