NO texture/cobblestone.xpm
SO texture/color_stone.xpm
WE texture/wall1v.xpm
EA texture/mycelium_top.xpm
F 139,69,19
C 135,206,235

1111111111
1000000001
1011101111
1000000W01
1111111111
