NO texture/cobblestone.xpm
SO texture/color_stone.xpm
WE texture/wall1v.xpm
EA texture/mycelium_top.xpm
F 139,69,19
C 135,206,235

1111111111111111111111111
1000000000011100000000001
1000000000000000000000001
1000000000000000000000001
1000000000000000000000001
1111111111111100000000001
1000000000000000000000001
11111111111111000000000011111111111111
11111111111111000000000000000000000001
            10000000000000000000000001
11111111111110000000000011111111111111
1000000000000000000000001
1000000000000000000000001
1000000000000000000000001
10000000000000000N0000001
1111111111111111111111111
