1111111111
1000000001
1001000001
1000001001
1111111111
