1111111111
1000000001
100100001
1000001001
1111111111