NO texture/wall3h.xpm
EA texture/mossy_cobblestone1.xpm
SO texture/wall2h.xpm
WE texture/cobblestone_02.xpm

C 255,200,160
F 122,122,  122

111111111
10N000001
111111111
