
NO texture/wall3h.xpm
EA texture/mossy_cobblestone1.xpm
SO texture/wall2h.xpm
WE texture/cobblestone_02.xpm

F 34,139,34
C 135,206,235

111111111111111111111111111111111111111
10ED00000000000000000000000000000000001
111111111111111111111111111111111111111
